###################################
#             #                   #
#    #    #             #    ##   #
#    #    #     #       ##   ##   #
#    #    #     ####    # #  ##   #
#    #   #      # ###   #  # ##   #
#       #       #  ###  #  # ##   #
#      #    #####    #  #  # ##   #
#     #    &    #       #  # ##   #
#    #                  #  #      #
#   #                   #         #
###################################