####################
#..................#
#..................#
#..................#
#..................#
#..................#
#..................#
#..................#
#..................#
#..................#
#........@.........#
#..................#
#..................#
#..................#
#..................#
#..................#
#..................#
#..................#
#..................#
####################
